Query	Parent	Child
aorta , abdominal	cardiovascular system	aorta , thoracic
factor ix	blood coagulation factors	pseudo leaf
physical and rehabilitation medicine	medicine	pseudo leaf
mesenchymal stem cells	pseudo root	pseudo leaf
ethics , nursing	ethics	pseudo leaf
fibroblast growth factor 8	receptors , fibroblast growth factor	pseudo leaf
adrenal cortex	pseudo root	pseudo leaf
bone matrix	bone and bones	pseudo leaf
clinical protocols	epidemiologic study characteristics	clinical trial protocols as topic
retrospective studies	epidemiologic studies	pseudo leaf
dna	nucleic acids	dna , ribosomal
fibroblast growth factors	peptides	fibroblast growth factor 5
insurance , nursing services	insurance benefits	pseudo leaf
genes , chloroplast	genes	pseudo leaf
color	ocular physiological phenomena	eye color
electrophoresis , paper	electrophoresis	pseudo leaf
hospitals , urban	health facilities	pseudo leaf
period circadian proteins	clock proteins	pseudo leaf
liposomes	lipids	pseudo leaf
drug resistance , bacterial	bacterial physiological phenomena	pseudo leaf
handling , psychological	behavior control	pseudo leaf
medicare	social security	pseudo leaf
culture media	pseudo root	pseudo leaf
israel	pseudo root	pseudo leaf
social skills	psychology , social	pseudo leaf
operative time	pseudo root	pseudo leaf
international system of units	pseudo root	pseudo leaf
burns , electric	burns	pseudo leaf
veterinary drugs	pharmaceutical preparations	pseudo leaf
resistance training	exercise movement techniques	pseudo leaf
touch perception	perception	pseudo leaf
parasitic diseases , animal	animal diseases	pseudo leaf
wrist injuries	hand injuries	pseudo leaf
posterior thalamic nuclei	thalamic nuclei	pseudo leaf
perioperative medicine	medicine	pseudo leaf
core binding factor alpha 2 subunit	core binding factors	pseudo leaf
recombination , genetic	transformation , genetic	pseudo leaf
fast foods	meals	pseudo leaf
pulse wave analysis	traditional pulse diagnosis	pseudo leaf
drug combinations	pharmaceutical preparations	pseudo leaf
polar bodies	pseudo root	pseudo leaf
adult survivors of child abuse	survivors	pseudo leaf
mentally disabled persons	disabled persons	pseudo leaf
secretory component	pseudo root	pseudo leaf
transplantation , autologous	transplantation	pseudo leaf
classical article	pseudo root	pseudo leaf
language arts	communication	pseudo leaf
income	economics	capital expenditures
body fluid compartments	extracellular space	pseudo leaf
consciousness monitors	pseudo root	pseudo leaf
ectopic gene expression	gene expression	pseudo leaf
duodenal obstruction	pseudo root	pseudo leaf
human growth hormone	pseudo root	pseudo leaf
retinal pigment epithelium	pseudo root	pseudo leaf
gray literature	literature	pseudo leaf
ribosome subunits , large , bacterial	rna , ribosomal	pseudo leaf
child reactive disorders	personality disorders	pseudo leaf
lipid droplets	lipids	pseudo leaf
cerebellar ataxia	ataxia	pseudo leaf
gene expression regulation	gene expression	pseudo leaf
femur head	femur	pseudo leaf
liver diseases	digestive system diseases	liver cirrhosis
polymorphism , restriction fragment length	polymorphism , genetic	pseudo leaf
receptors , estradiol	receptors , cytoplasmic and nuclear	pseudo leaf
reagent strips	pseudo root	pseudo leaf
islands	geographic locations	channel islands
manifest anxiety scale	test anxiety scale	pseudo leaf
receptors , death domain	receptors , cell surface	pseudo leaf
adrenal cortex diseases	central nervous system diseases	pseudo leaf
data collection	data science	pseudo leaf
extremities	body regions	foot
prosthesis fitting	prosthesis implantation	pseudo leaf
stromal interaction molecule 2	pseudo root	pseudo leaf
practice patterns , physicians '	health behavior	pseudo leaf
cranial nerve diseases	nervous system diseases	olfactory nerve diseases
litter size	body size	pseudo leaf
strategic planning	organization and administration	pseudo leaf
epidemiological monitoring	public health surveillance	pseudo leaf
platelet membrane glycoprotein iib	membrane glycoproteins	pseudo leaf
maternal welfare	social welfare	pseudo leaf
biomedical enhancement	biomedical technology	pseudo leaf
corneal stroma	cornea	pseudo leaf
accidents , home	disasters	pseudo leaf
leukemia , myeloid , acute	pseudo root	pseudo leaf
uterine cervical dysplasia	uterine cervical diseases	pseudo leaf
ireland	northern ireland	pseudo leaf
immunoglobulin domains	protein domains	pseudo leaf
core binding factor alpha 1 subunit	core binding factors	pseudo leaf
tomography , optical	tomography	electron microscope tomography
food safety	food quality	pseudo leaf
antiretroviral therapy , highly active	drug therapy	pseudo leaf
united states government agencies	government agencies	pseudo leaf
epidural neoplasms	spinal cord neoplasms	pseudo leaf
aortic arch syndromes	aortic diseases	pseudo leaf
ribosome subunits , small , bacterial	ribosomal proteins	pseudo leaf
heat exhaustion	heat stress disorders	heat stroke
public policy	social control , formal	pseudo leaf
group structure	group processes	pseudo leaf
small business	industry	pseudo leaf
nuclear reactors	weapons	pseudo leaf
cytoskeleton	cytoplasmic structures	pseudo leaf
beer	alcoholic beverages	pseudo leaf
carcinoma , transitional cell	carcinoma	pseudo leaf
protective clothing	personal protective equipment	pseudo leaf
foundations	health care economics and organizations	pseudo leaf
health planning support	health planning	pseudo leaf
arabia	asia , western	saudi arabia
dental plaque	dental deposits	pseudo leaf
child language	linguistics	pseudo leaf
form perception	perception	pseudo leaf
cell respiration	energy metabolism	pseudo leaf
metals , alkali	metals	pseudo leaf
body remains	physical appearance , body	pseudo leaf
capillary leak syndrome	peripheral vascular diseases	pseudo leaf
miller fisher syndrome	pseudo root	pseudo leaf
gaba agonists	gaba agents	pseudo leaf
death domain superfamily	pseudo root	pseudo leaf
collection	pseudo root	pseudo leaf
rehabilitation centers	health facilities	pseudo leaf
psychology , applied	behavioral sciences	pseudo leaf
dental prosthesis design	prosthesis design	pseudo leaf
rna , fungal	rna	pseudo leaf
historical article	pseudo root	pseudo leaf
eating	diet	fasting
dental clinics	dental facilities	pseudo leaf
pain , intractable	pain	pseudo leaf
skull	facial bones	pseudo leaf
carrier state	pseudo root	pseudo leaf
hypertension , pulmonary	hypertension	pseudo leaf
adoption	parenting	pseudo leaf
surrogate mothers	mothers	pseudo leaf
plasmids	bacterial structures	pseudo leaf
chromosomes , human , y	sex chromosomes	y chromosome
medical savings accounts	financial statements	pseudo leaf
rna , mitochondrial	pseudo root	pseudo leaf
measles vaccine	pseudo root	pseudo leaf
surgical clearance	surgical procedures , operative	pseudo leaf
truth disclosure	disclosure	pseudo leaf
thymic factor , circulating	thymus hormones	pseudo leaf
patient transfer	pseudo root	pseudo leaf
egg proteins , dietary	egg proteins	pseudo leaf
abdominal fat	pseudo root	pseudo leaf
wnt proteins	pseudo root	pseudo leaf
nucleotides , cyclic	nucleotides	pseudo leaf
bodily secretions	fluids and secretions	intestinal secretions
receptors , peptide	receptors , cell surface	pseudo leaf
phagocytosis	cell death	apoptosis
lakes	pseudo root	pseudo leaf
legislation , hospital	legislation as topic	pseudo leaf
judgment	mental processes	decision making
global health	pseudo root	pseudo leaf
intraocular lymphoma	lymphoma	pseudo leaf
hospital bed capacity , 100 to 299	capacity building	pseudo leaf
blood sedimentation	blood physiological phenomena	pseudo leaf
cerebral arterial diseases	intracranial arterial diseases	pseudo leaf
observational study	clinical study	pseudo leaf
occupational health nursing	nursing	pseudo leaf
lung diseases , parasitic	respiratory tract infections	pseudo leaf
reverse transcriptase polymerase chain reaction	reverse transcription	pseudo leaf
sensory thresholds	nervous system physiological phenomena	taste threshold
retirement	employment	pseudo leaf
anatomy , veterinary	anatomy	pseudo leaf
adaptor protein complex 1	pseudo root	pseudo leaf
economics , pharmaceutical	economics	pseudo leaf
ventricular function , right	cardiovascular physiological phenomena	pseudo leaf
pregnancy complications , cardiovascular	pregnancy complications	pseudo leaf
tool use behavior	behavior	pseudo leaf
colony count , microbial	microbiological techniques	pseudo leaf
sensation disorders	nervous system diseases	pseudo leaf
accessory nerve injuries	accessory nerve diseases	pseudo leaf
advanced cardiac life support	life support care	pseudo leaf
delivery rooms	hospital units	pseudo leaf
embryo disposition	fertilization	pseudo leaf
treatment outcome	prognosis	treatment failure
fees , pharmaceutical	fees and charges	pseudo leaf
dietary fiber	dietary supplements	pseudo leaf
absorption , radiation	radiation exposure	pseudo leaf
myocardium	pseudo root	pseudo leaf
work capacity evaluation	pseudo root	pseudo leaf
kidney tubules , collecting	kidney tubules	pseudo leaf
complement factor d	pseudo root	pseudo leaf
pregnancy , ovarian	pregnancy complications	pseudo leaf
bone neoplasms	bone diseases	pseudo leaf
library administration	organization and administration	pseudo leaf
solute carrier family 22 member 5	solute carrier proteins	pseudo leaf
creatine kinase , mitochondrial form	creatine kinase	pseudo leaf
cell membrane structures	cell	pseudo leaf
organic anion transport protein 1	organic cation transport proteins	pseudo leaf
aortic valve insufficiency	aortic diseases	pseudo leaf
psychology , sports	behavioral sciences	pseudo leaf
glasgow coma scale	pseudo root	pseudo leaf
air filters	air	pseudo leaf
pathology , oral	dentistry	pseudo leaf
brain tissue transplantation	tissue transplantation	pseudo leaf
combat disorders	mental disorders	pseudo leaf
reproductive rights	human rights	pseudo leaf
carcinoma , papillary	carcinoma	pseudo leaf
dental pulp	tooth components	dental pulp cavity
central nervous system fungal infections	central nervous system diseases	pseudo leaf
veins	blood vessels	pulmonary veins
taste perception	auditory perception	pseudo leaf
receptor , angiotensin , type 1	receptors , cytokine	pseudo leaf
models , immunological	models , theoretical	pseudo leaf
ethics committees	ethics , research	pseudo leaf
transportation	commerce	pseudo leaf
students , nursing	students	pseudo leaf
lipid accumulation product	pseudo root	pseudo leaf
light signal transduction	signal transduction	pseudo leaf
mitosis modulators	blood coagulation factor inhibitors	pseudo leaf
bones of upper extremity	bone and bones	pseudo leaf
health records , personal	records	pseudo leaf
brain injuries	central nervous system diseases	diffuse axonal injury
nuclear export signals	pseudo root	pseudo leaf
abdominal cavity	pseudo root	peritoneal cavity
organ dysfunction scores	pseudo root	pseudo leaf
online social networking	social networking	pseudo leaf
copper	metals , heavy	pseudo leaf
reproductive isolation	reproduction	pseudo leaf
fuzzy logic	artificial intelligence	pseudo leaf
job description	employment	pseudo leaf
base pairing	biochemical phenomena	pseudo leaf
rectal diseases	intestinal diseases	pseudo leaf
psychology	behavioral sciences	pseudo leaf
intercellular signaling peptides and proteins	peptides	pseudo leaf
electronic supplementary materials	publications	pseudo leaf
insurance , disability	insurance , health	pseudo leaf
rna splice sites	rna	pseudo leaf
mars	planets	pseudo leaf
kidneys , artificial	artificial organs	pseudo leaf
dilatation , pathologic	pathologic processes	pseudo leaf
prion diseases	central nervous system diseases	pseudo leaf
hepatitis b core antigens	hepatitis antigens	pseudo leaf
carcinoma , ductal	endocrine gland neoplasms	carcinoma , pancreatic ductal
workplace violence	crime	pseudo leaf
abdominal muscles	muscles	abdominal oblique muscles
skull base	skeleton	pseudo leaf
liver regeneration	regeneration	pseudo leaf
type b personality	personality	pseudo leaf
arthroplasty , replacement , shoulder	arthroplasty	pseudo leaf
forms and records control	organization and administration	pseudo leaf
abortion , legal	pseudo root	pseudo leaf
chief executive officers , hospital	hospital administrators	pseudo leaf
account book	records	pseudo leaf
cataract extraction	pseudo root	pseudo leaf
essay	pseudo root	pseudo leaf
food analysis	food quality	food inspection
heart	cardiovascular system	pseudo leaf
social marketing	marketing	pseudo leaf
data mining	data science	pseudo leaf
olfactory perception	auditory perception	pseudo leaf
popular work	publication formats	pseudo leaf
fractional precipitation	chemical fractionation	pseudo leaf
mutation	genetic variation	pseudo leaf
paper	publication formats	manuscript
hypothalamus , middle	hypothalamus	pseudo leaf
neurological rehabilitation	rehabilitation	pseudo leaf
maximum allowable concentration	occupational exposure	pseudo leaf
postoperative nausea and vomiting	nausea	pseudo leaf
meningitis , pneumococcal	pneumonia	pseudo leaf
combined modality therapy	radiotherapy	pseudo leaf
cardiac surgical procedures	cardiovascular surgical procedures	pseudo leaf
dynamic light scattering	spectrum analysis	pseudo leaf
association learning	association	pseudo leaf
fish proteins , dietary	fish proteins	pseudo leaf
geographic area	pseudo root	pseudo leaf
leishmania major	leishmania	pseudo leaf
paralysis	neurologic manifestations	facial paralysis
united states office of national drug control policy	pseudo root	pseudo leaf
ovarian follicle	ovary	pseudo leaf
stem cells	cells	neoplastic stem cells
genetic fitness	genetic phenomena	pseudo leaf
apnea	respiration disorders	pseudo leaf
brain injuries , traumatic	wounds and injuries	pseudo leaf
prenatal care	maternal health services	pseudo leaf
membranes , artificial	pseudo root	pseudo leaf
taste disorders	mouth diseases	pseudo leaf
interview , psychological	interview	pseudo leaf
adaptation , psychological	human development	pseudo leaf
melanoma	carcinoma	pseudo leaf
pathology , veterinary	veterinary medicine	pseudo leaf
protective devices	personal protective equipment	ear protective devices
receptors , artificial	pseudo root	pseudo leaf
plant viral movement proteins	viral proteins	pseudo leaf
attitude to health	attitude	pseudo leaf
neurotoxicity syndromes	neurologic manifestations	pseudo leaf
lighting	pseudo root	pseudo leaf
social behavior	behavior	social dominance
olfactory pathways	auditory pathways	pseudo leaf
hematologic tests	pseudo root	pseudo leaf
bone density conservation agents	pseudo root	pseudo leaf
thoracic wall	skeleton	pseudo leaf
serine proteinase inhibitors	pseudo root	pseudo leaf
vascular diseases	cardiovascular diseases	vascular malformations
exercise therapy	physical therapy modalities	exercise movement techniques
dendrites	neurons	dendritic spines
reproductive health	pseudo root	pseudo leaf
epileptic syndromes	epilepsy	pseudo leaf
survival rate	survival analysis	pseudo leaf
oral ulcer	oral manifestations	pseudo leaf
patient care team	health care activity	pseudo leaf
hospitals , general	hospital units	pseudo leaf
receptors , angiotensin	receptors , cell surface	pseudo leaf
iran	pseudo root	pseudo leaf
photons	electrons	pseudo leaf
creatine kinase , bb form	creatine kinase	pseudo leaf
outpatient clinics , hospital	health facilities	pseudo leaf
femoral artery	iliac artery	pseudo leaf
anemia , refractory	anemia	pseudo leaf
retinal degeneration	retinal diseases	pseudo leaf
erythrocyte aggregation	cell aggregation	pseudo leaf
portion size	serving size	pseudo leaf
auditory brain stem implantation	cochlear implantation	pseudo leaf
management information systems	organization and administration	pseudo leaf
secretory vesicles	extracellular vesicles	pseudo leaf
purchasing , hospital	ownership	pseudo leaf
college admission test	school admission criteria	pseudo leaf
patient care planning	pseudo root	pseudo leaf
disease models , animal	models , biological	pseudo leaf
heavy metal poisoning	poisoning	pseudo leaf
pancreatic fistula	pancreatic diseases	pseudo leaf
religion and science	pseudo root	pseudo leaf
ventral striatum	pseudo root	pseudo leaf
blood circulation	cardiovascular physiological phenomena	pseudo leaf
cobalt isotopes	cobalt	pseudo leaf
nursing service , hospital	hospital administration	pseudo leaf
insurance , psychiatric	insurance benefits	pseudo leaf
anger	emotions	pseudo leaf
age groups	population groups	pseudo leaf
medicare part b	pseudo root	pseudo leaf
vaccines , contraceptive	vaccines	pseudo leaf
hardness	hardness tests	pseudo leaf
salivary ducts	salivary glands	salivary glands , minor
oxytocin	pseudo root	pseudo leaf
smoking cessation	smoking reduction	pseudo leaf
pulmonary surfactants	cardiovascular agents	pseudo leaf
education , nursing , associate	education , graduate	pseudo leaf
raf kinases	pseudo root	pseudo leaf
motor vehicles	pseudo root	pseudo leaf
systems biology	biology	pseudo leaf
transplant recipients	persons	pseudo leaf
chlorophyll a	chlorophyll	pseudo leaf
logistic models	models , statistical	pseudo leaf
electronic waste	hazardous waste	pseudo leaf
central nervous system bacterial infections	central nervous system infections	pseudo leaf
united states public health service	pseudo root	pseudo leaf
activities of daily living	human activities	pseudo leaf
rats , inbred shr	rats	pseudo leaf
endothelial progenitor cells	endothelial cells	pseudo leaf
erythrocyte count	blood cell count	pseudo leaf
virus shedding	virus release	pseudo leaf
sex work	sexual behavior	pseudo leaf
nursing services	health services	pseudo leaf
tumor escape	immunity	pseudo leaf
behavioral symptoms	signs and symptoms	pseudo leaf
relative biological effectiveness	radiation dosage	pseudo leaf
polysaccharides , bacterial	polysaccharides	pseudo leaf
argentina	south america	pseudo leaf
veterans health	military health	pseudo leaf
rna , algal	rna	pseudo leaf
selenium	selenium compounds	selenium oxides
public housing	pseudo root	pseudo leaf
carcinoma , squamous cell	carcinoma	pseudo leaf
peer influence	group processes	pseudo leaf
hematopoietic stem cell mobilization	pseudo root	pseudo leaf
disability evaluation	pseudo root	pseudo leaf
hereditary sensory and motor neuropathy	peripheral nervous system diseases	pseudo leaf
nursing assessment	nursing process	pseudo leaf
mediterranean islands	pseudo root	pseudo leaf
dental caries activity tests	pseudo root	pseudo leaf
forensic pathology	forensic medicine	pseudo leaf
contraception	reproductive techniques	hormonal contraception
occipital lobe	parietal lobe	pseudo leaf
manufactured materials	technology	pseudo leaf
tonic pupil	eye abnormalities	pseudo leaf
microscopy , scanning probe	diagnostic imaging	pseudo leaf
nuclease protection assays	enzyme assays	pseudo leaf
sleep hygiene	hygiene	pseudo leaf
identity crisis	conflict , psychological	pseudo leaf
exosomes	extracellular vesicles	pseudo leaf
state medicine	social control , formal	pseudo leaf
aneurysm	cardiovascular diseases	heart rupture
gene dosage	gene expression	pseudo leaf
diet , healthy	diet	pseudo leaf
pleural cavity	respiratory mucosa	pseudo leaf
reproductive physiological phenomena	physiological phenomena	sexual maturation
actin cytoskeleton	cytoskeletal proteins	pseudo leaf
osteoporosis	bone diseases	osteoporosis , postmenopausal
blindness	vision disorders	night blindness
education , medical , continuing	education , continuing	pseudo leaf
salt stress	pseudo root	pseudo leaf
lymphocyte antigen 96	pseudo root	pseudo leaf
dental prosthesis repair	prosthesis implantation	pseudo leaf
nervous system autoimmune disease , experimental	nervous system diseases	pseudo leaf
hospitals , pediatric	hospitals , special	pseudo leaf
bronchial neoplasms	bronchial diseases	pseudo leaf
viral envelope proteins	viral proteins	pseudo leaf
anal canal	rectum	pseudo leaf
pain management	rehabilitation	pseudo leaf
mycobacterium tuberculosis	tuberculosis	pseudo leaf
animal proteins , dietary	dietary proteins	pseudo leaf
lewis acids	organic chemicals	lewis bases
leukocyte reduction procedures	leukocyte transfusion	pseudo leaf
lactation	digestion	pseudo leaf
child welfare	social welfare	pseudo leaf
disease eradication	disease transmission , infectious	pseudo leaf
neoplastic process	neoplastic processes	cell transformation , neoplastic
manual lymphatic drainage	drainage	pseudo leaf
mirror neurons	neurons	pseudo leaf
headache disorders , primary	headache disorders	pseudo leaf
asian continental ancestry group	continental population groups	pseudo leaf
glycogen storage disease type iv	metabolic syndrome	pseudo leaf
single photon emission computed tomography computed tomography	tomography	pseudo leaf
nuclear envelope	cytoplasmic structures	pseudo leaf
international classification of functioning , disability and health	pseudo root	pseudo leaf
acute disease	disease	pseudo leaf
patient positioning	movement	pseudo leaf
emergence delirium	pseudo root	pseudo leaf
dental etching	tooth preparation	acid etching , dental
biological transport , active	metabolism	pseudo leaf
focal epithelial hyperplasia	hyperplasia	pseudo leaf
metals , light	metals , heavy	pseudo leaf
paternal age	family characteristics	pseudo leaf
respiratory aspiration of gastric contents	respiratory aspiration	pseudo leaf
dual use research	research	pseudo leaf
diagnostic techniques , neurological	diagnostic techniques and procedures	neurologic examination
axillary artery	arteries	pseudo leaf
nanostructures	nanotubes	pseudo leaf
fatty liver	liver	pseudo leaf
synovial cyst	pseudo root	pseudo leaf
dermatitis , occupational	occupational diseases	pseudo leaf
multiplex polymerase chain reaction	pseudo root	pseudo leaf
multiple system atrophy	atrophy	pseudo leaf
health plan implementation	health planning	pseudo leaf
growth differentiation factor 2	growth differentiation factors	pseudo leaf
epithelial cells	endothelial cells	pseudo leaf
dermatitis , allergic contact	dermatitis	pseudo leaf
death effector domain	pseudo root	pseudo leaf
cord factors	pseudo root	pseudo leaf
hospital departments	hospital units	pseudo leaf
educational activity	event	research activity
fish oils	oils	pseudo leaf
poultry	birds	chickens
hypertensive retinopathy	ocular hypertension	pseudo leaf
hospital bed capacity	pseudo root	pseudo leaf
pregnancy , prolonged	pregnancy complications	pseudo leaf
colitis	colonic diseases	colitis , microscopic
parental notification	parenting	pseudo leaf
indole alkaloids	alkaloids	pseudo leaf
database	pseudo root	pseudo leaf
airway management	patient care management	pseudo leaf
child guidance	child development	pseudo leaf
sodium bicarbonate	sodium compounds	pseudo leaf
electrophoresis , cellulose acetate	electrophoresis	pseudo leaf
anxiety , separation	anxiety	pseudo leaf
healthy lifestyle	life style	healthy aging
tissue extracts	pharmaceutical preparations	pseudo leaf
subcutaneous absorption	digestive system physiological phenomena	pseudo leaf
receptors , chemokine	receptors , cell surface	pseudo leaf
peptide termination factors	peptides	pseudo leaf
bayes theorem	pseudo root	pseudo leaf
tinnitus	hearing disorders	pseudo leaf
fees , medical	fees and charges	pseudo leaf
computer graphics	computing methodologies	pseudo leaf
abortion applicants	persons	pseudo leaf
skin absorption	skin physiological phenomena	pseudo leaf
african union	pseudo root	pseudo leaf
travel	movement	walking speed
fatty acid transport proteins	membrane transport proteins	pseudo leaf
musculoskeletal physiological phenomena	pseudo root	musculoskeletal development
phantom limb	neuromuscular manifestations	pseudo leaf
tablets	pharmaceutical preparations	pseudo leaf
peripheral nerves	peripheral nervous system	cranial nerves
lipid metabolism disorders	nutritional and metabolic diseases	pseudo leaf
forensic toxicology	forensic medicine	pseudo leaf
biological monitoring	monitoring , physiologic	drug monitoring
live birth	pregnancy	pseudo leaf
hemodialysis units , hospital	respiratory care units	pseudo leaf
cold injury	wounds and injuries	heat stroke
genetic testing	genetic techniques	dna mutational analysis
elasticity imaging techniques	diagnostic imaging	pseudo leaf
speech recognition software	natural language processing	pseudo leaf
violence	crime	domestic violence
gc rich sequence	base sequence	pseudo leaf
spores , fungal	fungal structures	pseudo leaf
iron carbonyl compounds	iron compounds	pseudo leaf
friends	persons	pseudo leaf
uterine rupture	uterine diseases	pseudo leaf
psychology , developmental	psychological phenomena	pseudo leaf
kidney cortex necrosis	kidney diseases	pseudo leaf
genes , synthetic	genes	pseudo leaf
sugar acids	sugars	pseudo leaf
housing	residence characteristics	pseudo leaf
s phase	cell nucleus division	pseudo leaf
fatty acids	lipids	fatty alcohols
laboratory procedure	pseudo root	pseudo leaf
ultrasonic waves	radio waves	pseudo leaf
in situ hybridization , fluorescence	staining and labeling	in situ hybridization
health planning guidelines	health planning	pseudo leaf
anomalous left coronary artery	central nervous system vascular malformations	pseudo leaf
legislation , food	legislation as topic	pseudo leaf
sleep stages	pseudo root	pseudo leaf
renal blood flow , effective	renal plasma flow	pseudo leaf
excitatory amino acid transporter 4	membrane transport proteins	pseudo leaf
protein corona	pseudo root	pseudo leaf
fibrin clot lysis time	blood circulation time	pseudo leaf
greek world	pseudo root	pseudo leaf
clay	soil	pseudo leaf
laboratory infection	infections	pseudo leaf
eye injuries	wounds and injuries	pseudo leaf
lithium	metals , heavy	pseudo leaf
estrogen receptor alpha	pseudo root	pseudo leaf
models , molecular	models , theoretical	pseudo leaf
periodic acid	pseudo root	pseudo leaf
muscle strength	body weights and measures	pseudo leaf
fetal resorption	embryonic and fetal development	pseudo leaf
probability learning	probability	pseudo leaf
drug industry	manufacturing industry	pseudo leaf
health impact assessment	pseudo root	pseudo leaf
pain perception	perception	pseudo leaf
editorial	publication formats	pseudo leaf
cerebellar neoplasms	central nervous system neoplasms	pseudo leaf
religion and medicine	medicine	pseudo leaf
ion channel gating	sensory gating	pseudo leaf
veterans disability claims	civil disorders	pseudo leaf
trigger points	pseudo root	pseudo leaf
books	publications	books , illustrated
radiation oncology	radiology	pseudo leaf
metabolic side effects of drugs and substances	metabolic diseases	pseudo leaf
milk , human	milk	pseudo leaf
preexisting condition coverage	insurance benefits	pseudo leaf
intracellular membranes	intracellular space	endoplasmic reticulum
conservative treatment	therapeutics	pseudo leaf
thermal diffusion	diffusion	pseudo leaf
tobacco smoking	cigarette smoking	pseudo leaf
hepatitis , animal	hepatitis	pseudo leaf
fresh water	water resources	pseudo leaf
anatomical abnormality	anatomical structure	congenital abnormality
optical phenomena	pseudo root	refraction , ocular
early growth response protein 1	pseudo root	pseudo leaf
brain neoplasms	central nervous system neoplasms	pseudo leaf
adenocarcinoma in situ	adenocarcinoma	pseudo leaf
reference standards	health care evaluation mechanisms	pseudo leaf
diabetes mellitus , type 2	diabetes mellitus	pseudo leaf
obstetric labor , premature	obstetric labor complications	pseudo leaf
cadmium compounds	inorganic chemicals	cadmium chloride
feeder cells	cells	pseudo leaf
narrative medicine	pseudo root	pseudo leaf
meat proteins	dietary proteins	pseudo leaf
idea or concept	conceptual entity	pseudo leaf
nigeria	central african republic	pseudo leaf
protective factors	epidemiologic factors	pseudo leaf
cell adhesion molecules , neuronal	membrane proteins	neural cell adhesion molecules
transition elements	elements	pseudo leaf
gallbladder	pseudo root	pseudo leaf
muscle weakness	muscular diseases	pseudo leaf
urbanization	sociology	urban renewal
shoulder joint	joints	pseudo leaf
sclerosis	fibrosis	pseudo leaf
social values	socioeconomic factors	pseudo leaf
corneal perforation	corneal diseases	pseudo leaf
noise , occupational	noise	pseudo leaf
blood protein disorders	blood coagulation disorders	pseudo leaf
absorption	physical phenomena	absorption , physicochemical
chlorine compounds	inorganic chemicals	pseudo leaf
blood pressure monitoring , ambulatory	monitoring , ambulatory	pseudo leaf
pseudomonas vaccines	viral vaccines	pseudo leaf
biologic function	natural phenomenon or process	pseudo leaf
device approval	pseudo root	pseudo leaf
drug administration schedule	pharmacy administration	pseudo leaf
pain threshold	sensation	pseudo leaf
nuclear proteins	blood coagulation factor inhibitors	nuclear respiratory factors
atp binding cassette transporter , subfamily g , member 2	atp binding cassette transporter , subfamily g	pseudo leaf
pancreas , artificial	pancreas	pseudo leaf
yeast , dried	pseudo root	pseudo leaf
spiral ganglion	pseudo root	pseudo leaf
single person	persons	pseudo leaf
intelligence	cognition	pseudo leaf
egg shell	animal shells	pseudo leaf
proportional hazards models	models , statistical	pseudo leaf
freedom	human rights	genetic privacy
posterior cerebral artery	cerebral arteries	pseudo leaf
molar , third	molar	pseudo leaf
erythrocyte indices	pseudo root	pseudo leaf
prenatal injuries	birth injuries	pseudo leaf
community participation	social participation	pseudo leaf
organ preservation solutions	organ preservation	pseudo leaf
computed tomography angiography	tomography	pseudo leaf
physician payment review commission	pseudo root	pseudo leaf
radiography , dental , digital	radiography	pseudo leaf
cerebral angiography	angiography	pseudo leaf
ureter	kidney pelvis	pseudo leaf
prostatic diseases	genital diseases , male	prostatic hyperplasia
confidence intervals	pseudo root	pseudo leaf
splenic infarction	venous insufficiency	pseudo leaf
rupture , spontaneous	rupture	pseudo leaf
pulmonary ventilation	pulmonary circulation	pseudo leaf
infection control practitioners	general practitioners	pseudo leaf
milk banks	farms	pseudo leaf
elimination disorders	pseudo root	pseudo leaf
directed molecular evolution	pseudo root	pseudo leaf
new south wales	australia	pseudo leaf
thyroid nuclear factor 1	pseudo root	pseudo leaf
parasitic sensitivity tests	microbial sensitivity tests	disk diffusion antimicrobial tests
systematic review	peer review , research	pseudo leaf
united states department of agriculture	federal government	pseudo leaf
neuromuscular blocking agents	nerve agents	pseudo leaf
lip diseases	mouth diseases	lip neoplasms
orthopedic procedures	surgical procedures , operative	pseudo leaf
genes , bacterial	genes , microbial	pseudo leaf
chronic disease	disease	pseudo leaf
insurance coverage	insurance	pseudo leaf
saliva	fluids and secretions	pseudo leaf
brain edema	hypoxia , brain	pseudo leaf
gene pool	genetic phenomena	pseudo leaf
plant proteins , dietary	plant proteins	pseudo leaf
sex characteristics	pseudo root	pseudo leaf
epidemiology	medicine	molecular epidemiology
orthodontic wires	electrical equipment and supplies	pseudo leaf
coup transcription factors	transcription factors	pseudo leaf
prospective studies	epidemiologic studies	pseudo leaf
neonatal brachial plexus palsy	pseudo root	pseudo leaf
atp binding cassette transporter , subfamily b , member 2	atp binding cassette transporter , subfamily a	pseudo leaf
western australia	australia	pseudo leaf
lymphatic system	immune system	lymphatic vessels
enhanced recovery after surgery	pseudo root	pseudo leaf
articulation disorders	speech disorders	pseudo leaf
eye infections , parasitic	parasitic diseases	pseudo leaf
alpha rhythm	brain waves	pseudo leaf
poverty areas	poverty	pseudo leaf
education , veterinary	education , medical	pseudo leaf
hydrophobic and hydrophilic interactions	pseudo root	pseudo leaf
meningitis , viral	meningitis , bacterial	pseudo leaf
sand	soil	pseudo leaf
acidosis , renal tubular	metabolic diseases	pseudo leaf
seasons	climatic processes	pseudo leaf
cerebrospinal fluid pressure	intracranial pressure	pseudo leaf
dental marginal adaptation	dental restoration , permanent	pseudo leaf
maze procedure	cardiovascular surgical procedures	pseudo leaf
health facility administrators	health personnel	pseudo leaf
fluorescent antibody technique , direct	fluorescent antibody technique	pseudo leaf
lens , crystalline	eye	pseudo leaf
prefrontal cortex	frontal lobe	pseudo leaf
crack cocaine	cocaine	pseudo leaf
physicians ' offices	private practice	pseudo leaf
receptors , glucocorticoid	pseudo root	glucocorticoids
north sea	atlantic ocean	pseudo leaf
atmospheric pressure	atmosphere	pseudo leaf
forensic genetics	forensic medicine	pseudo leaf
soil microbiology	environmental microbiology	pseudo leaf
tibia	leg bones	pseudo leaf
outline	form	pseudo leaf
pattern recognition , visual	pattern recognition , physiological	pseudo leaf
jordan	pseudo root	pseudo leaf
radiotherapy dosage	radiotherapy	pseudo leaf
genes , rev	genes , viral	pseudo leaf
rrna operon	pseudo root	pseudo leaf
united states department of veterans affairs	united states department of defense	pseudo leaf
membrane potential , mitochondrial	membrane potentials	pseudo leaf
pair bond	reproduction	pseudo leaf
leukocytes	immune system	lymphocytes
dental casting technique	technology , dental	dental impression technique
ear neoplasms	ear diseases	pseudo leaf
random allocation	pseudo root	pseudo leaf
artificial lens implant migration	lens diseases	pseudo leaf
radiation hybrid mapping	molecular probe techniques	pseudo leaf
sepsis	systemic inflammatory response syndrome	neonatal sepsis
pediatrics	pseudo root	pseudo leaf
microtubule proteins	pseudo root	pseudo leaf
asthma , occupational	occupational diseases	pseudo leaf
lateral thalamic nuclei	thalamic nuclei	pseudo leaf
acoustic impedance tests	hearing tests	pseudo leaf
nadh dehydrogenase	aldehyde dehydrogenase	pseudo leaf
radiation effects	radiation	radiation , ionizing
pregnancy proteins	amino acids , peptides , and proteins	placenta growth factor
logical observation identifiers names and codes	pseudo root	pseudo leaf
dna replication timing	dna replication	pseudo leaf
saccharomyces cerevisiae proteins	saccharomyces cerevisiae	pseudo leaf
psychological tests	behavioral disciplines and activities	personality tests
bacillus subtilis	bacillus	pseudo leaf
occupational health	environment and public health	occupational exposure
mathematical computing	artificial intelligence	pseudo leaf
limited english proficiency	literacy	pseudo leaf
elbow joint	forearm injuries	pseudo leaf
antisense elements ( genetics )	pseudo root	pseudo leaf
water pollution , chemical	water pollution	pseudo leaf
antibodies , immobilized	antibodies	pseudo leaf
tissue engineering	engineering	pseudo leaf
patient discharge	pseudo root	pseudo leaf
connective tissue cells	cells	adipocytes
genome , plant	genome	pseudo leaf
focal infection	infections	pseudo leaf
amino acid transport systems , basic	pseudo root	pseudo leaf
drugs , chinese herbal	pharmaceutical preparations	pseudo leaf
wounds , penetrating	wounds and injuries	pseudo leaf
expert systems	computer systems	pseudo leaf
insect viruses	fungal viruses	pseudo leaf
quality assurance , health care	quality of health care	pseudo leaf
lysine	pseudo root	pseudo leaf
midline thalamic nuclei	thalamic nuclei	pseudo leaf
ultrasonic surgical procedures	ultrasonic therapy	pseudo leaf
infection control , dental	infection control	pseudo leaf
hot melt extrusion technology	pseudo root	pseudo leaf
tuberculosis , pulmonary	lung diseases	pseudo leaf
rna precursors	rna	rna caps
philosophy , medical	philosophy	pseudo leaf
problem solving	learning	pseudo leaf
orthopedic surgeons	surgeons	pseudo leaf
streptavidin	pseudo root	pseudo leaf
intention to treat analysis	epidemiologic study characteristics	pseudo leaf
insulin antibodies	antibodies	pseudo leaf
type d personality	personality	pseudo leaf
auditory threshold	auditory perception	pseudo leaf
neoplasm recurrence , local	recurrence	pseudo leaf
cyclic imp	cyclic amp	pseudo leaf
personnel management	organization and administration	pseudo leaf
state health planning and development agencies	government agencies	pseudo leaf
catalog	publication formats	pseudo leaf
fluorescence	spectrometry , fluorescence	fluorescence resonance energy transfer
handbook	publication formats	pseudo leaf
counseling	mental health services	sex counseling
recycling	pseudo root	pseudo leaf
family separation	family characteristics	pseudo leaf
cholinergic antagonists	cholinergic agents	pseudo leaf
rats , inbred wf	rats , inbred strains	pseudo leaf
dental records	records	pseudo leaf
integrated advanced information management systems	health information systems	pseudo leaf
pneumonia , pneumococcal	pneumonia	pseudo leaf
fluorescent dyes	pseudo root	pseudo leaf
eye infections , viral	virus diseases	pseudo leaf
muscle fibers , skeletal	muscle , skeletal	pseudo leaf
plaque , amyloid	pseudo root	pseudo leaf
serotonin antagonists	serotonin agents	pseudo leaf
temporal bone	jaw	pseudo leaf
biologically active substance	pharmacologic substance	pseudo leaf
dictionary , dental	dictionary	pseudo leaf
protein degradation end products	pseudo root	pseudo leaf
vomiting	pseudo root	pseudo leaf
lecture	address	pseudo leaf
reality testing	personality tests	pseudo leaf
nerve regeneration	regeneration	pseudo leaf
sequence deletion	mutagenesis	chromosome deletion
rural health	urban health	pseudo leaf
vaginal fistula	vaginal diseases	pseudo leaf
spindle apparatus	pseudo root	pseudo leaf
burn units	hospital units	pseudo leaf
skin ulcer	skin diseases	pseudo leaf
isotopes	elements	carbon isotopes
ferm domains	protein domains	pseudo leaf
fat body	pseudo root	pseudo leaf
ion channels	membrane glycoproteins	acid sensing ion channels
glia maturation factor	pseudo root	pseudo leaf
sugar alcohols	alcohols	pseudo leaf
bile ducts	liver	pseudo leaf
health facility environment	environment	pseudo leaf
tears	fluids and secretions	pseudo leaf
animals , inbred strains	animals	pseudo leaf
intensive care units	hospital units	pseudo leaf
cortical spreading depression	pseudo root	pseudo leaf
hair cells , auditory , outer	hair cells , auditory	pseudo leaf
umbilical cord	fetus	pseudo leaf
chemical engineering	engineering	pseudo leaf
williams syndrome	aortic diseases	pseudo leaf
organizations	health care economics and organizations	consumer organizations
rectal fistula	urinary fistula	pseudo leaf
atp binding cassette transporter , subfamily b , member 3	atp binding cassette transporter , subfamily b	pseudo leaf
house calls	home care services	pseudo leaf
historical geographic locations	geographic locations	pseudo leaf
cpg islands	chromosome structures	pseudo leaf
angiotensin ii type 1 receptor blockers	angiotensin receptor antagonists	pseudo leaf
adrenal glands	endocrine glands	pseudo leaf
science in the arts	art	pseudo leaf
patient identification systems	information systems	pseudo leaf
mental healing	mental health recovery	pseudo leaf
online systems	computer systems	pseudo leaf
brain diseases	nervous system diseases	cranial nerve injuries
observer variation	pseudo root	pseudo leaf
hypertension , portal	hypertension	pseudo leaf
postoperative complications	intraoperative complications	pseudo leaf
animal fur	animal structures	wool
silicon dioxide	silicon compounds	pseudo leaf
sudden infant death	infant death	pseudo leaf
continuity of patient care	delivery of health care	pseudo leaf
hiv long terminal repeat	terminal repeat sequences	pseudo leaf
tai ji	pseudo root	pseudo leaf
antigens , differentiation	antigens	pseudo leaf
neck injuries	wounds and injuries	pseudo leaf
safety management	risk management	pseudo leaf
data systems	information systems	pseudo leaf
serum sickness	immune complex diseases	pseudo leaf
sentinel surveillance	population surveillance	pseudo leaf
dental instruments	dental equipment	pseudo leaf
schools , pharmacy	schools	pseudo leaf
purple membrane	pseudo root	pseudo leaf
food , preserved	food and beverages	pseudo leaf
nitrogen compounds	inorganic chemicals	nitrogen oxides
community psychiatry	psychiatry	pseudo leaf
names	pseudo root	pseudo leaf
abdomen , acute	pseudo root	pseudo leaf
hydrogen bonding	pseudo root	pseudo leaf
facial asymmetry	facial expression	pseudo leaf
quartz	minerals	pseudo leaf
sodium acetate	sodium compounds	pseudo leaf
receptors , tumor necrosis factor	tumor necrosis factors	pseudo leaf
receptors , thyroid hormone	blood coagulation factor inhibitors	thyroid hormone receptors alpha
cell fusion	cell physiological phenomena	pseudo leaf
group practice , dental	organization	pseudo leaf
portugal	spain	pseudo leaf
infarction , posterior cerebral artery	infarction	pseudo leaf
adrenal cortex function tests	neurologic examination	pseudo leaf
posture	movement	gait
transition to adult care	patient care	pseudo leaf
air bags	pseudo root	pseudo leaf
silver staining	silver compounds	silver nitrate
aids dementia complex	dementia	pseudo leaf
pulmonary valve	heart valves	pseudo leaf
cos cells	pseudo root	pseudo leaf
renal insufficiency	kidney diseases	kidney tubular necrosis , acute
ethics , professional	ethics	pseudo leaf
abbreviations	terminology	pseudo leaf
