Query	Parent	Child
aorta , abdominal	arteries	aorta , thoracic
factor ix	factor x	pseudo leaf
physical and rehabilitation medicine	medicine	pseudo leaf
mesenchymal stem cells	adult stem cells	pseudo leaf
ethics , nursing	ethics , clinical	ethics , medical
fibroblast growth factor 8	angiogenic proteins	pseudo leaf
adrenal cortex	endocrine system	adrenal medulla
bone matrix	organism	pseudo leaf
clinical protocols	diagnostic techniques and procedures	pseudo leaf
retrospective studies	epidemiologic study characteristics	pseudo leaf
dna	base sequence	pseudo leaf
fibroblast growth factors	angiogenic proteins	pseudo leaf
insurance , nursing services	insurance , health	insurance , physician services
genes , chloroplast	genes	pseudo leaf
color	time	pseudo leaf
electrophoresis , paper	electrophoresis , polyacrylamide gel	native polyacrylamide gel electrophoresis
hospitals , urban	hospitals , public	pseudo leaf
period circadian proteins	transcription factors	pseudo leaf
liposomes	insect hormones	pseudo leaf
drug resistance , bacterial	drug resistance , microbial	tetracycline resistance
handling , psychological	physical conditioning , human	pseudo leaf
medicare	medical assistance	medicare part c
culture media	diagnostic uses of chemicals	pseudo leaf
israel	middle east	pseudo leaf
social skills	social control , informal	pseudo leaf
operative time	severity of illness index	pseudo leaf
international system of units	models , theoretical	pseudo leaf
burns , electric	electric injuries	pseudo leaf
veterinary drugs	technology , pharmaceutical	pseudo leaf
resistance training	physical conditioning , human	pseudo leaf
touch perception	pattern recognition , physiological	pseudo leaf
parasitic diseases , animal	infections	pseudo leaf
wrist injuries	leg injuries	pseudo leaf
posterior thalamic nuclei	thalamic nuclei	anterior thalamic nuclei
perioperative medicine	clinical medicine	pseudo leaf
core binding factor alpha 2 subunit	core binding factors	pseudo leaf
recombination , genetic	gene rearrangement	pseudo leaf
fast foods	foods , specialized	pseudo leaf
pulse wave analysis	blood pressure determination	pseudo leaf
drug combinations	physiological effects of drugs	pseudo leaf
polar bodies	cells	pseudo leaf
adult survivors of child abuse	survivors	pseudo leaf
mentally disabled persons	disabled persons	pseudo leaf
secretory component	peptides	pseudo leaf
transplantation , autologous	tissue transplantation	pseudo leaf
classical article	publication formats	pseudo leaf
language arts	language	pseudo leaf
income	costs and cost analysis	pseudo leaf
body fluid compartments	fluids and secretions	pseudo leaf
consciousness monitors	pseudo root	pseudo leaf
ectopic gene expression	gene expression regulation , neoplastic	pseudo leaf
duodenal obstruction	respiratory tract diseases	pseudo leaf
human growth hormone	pituitary hormones , posterior	pseudo leaf
retinal pigment epithelium	heart septum	pseudo leaf
gray literature	publications	pseudo leaf
ribosome subunits , large , bacterial	ribosome subunits , small	pseudo leaf
child reactive disorders	pseudo root	pseudo leaf
lipid droplets	subcellular fractions	pseudo leaf
cerebellar ataxia	central nervous system diseases	pseudo leaf
gene expression regulation	gene expression regulation , neoplastic	pseudo leaf
femur head	femur	femur neck
liver diseases	digestive system diseases	hepatic insufficiency
polymorphism , restriction fragment length	genomic structural variation	pseudo leaf
receptors , estradiol	receptors , cytoplasmic and nuclear	pseudo leaf
reagent strips	technology , pharmaceutical	pseudo leaf
islands	atlantic islands	pseudo leaf
manifest anxiety scale	personality tests	pseudo leaf
receptors , death domain	transcription factors	pseudo leaf
adrenal cortex diseases	endocrine system diseases	adrenal insufficiency
data collection	information science	pseudo leaf
extremities	body regions	pseudo leaf
prosthesis fitting	surgical fixation devices	pseudo leaf
stromal interaction molecule 2	pseudo root	pseudo leaf
practice patterns , physicians '	informed consent	pseudo leaf
cranial nerve diseases	nervous system diseases	pseudo leaf
litter size	morbidity	pseudo leaf
strategic planning	diffusion of innovation	pseudo leaf
epidemiological monitoring	health surveys	pseudo leaf
platelet membrane glycoprotein iib	receptors , cytoplasmic and nuclear	pseudo leaf
maternal welfare	social welfare	infant welfare
biomedical enhancement	diagnostic services	pseudo leaf
corneal stroma	anterior chamber	pseudo leaf
accidents , home	accidents	pseudo leaf
leukemia , myeloid , acute	leukemia virus , murine	pseudo leaf
uterine cervical dysplasia	uterine cervical diseases	pseudo leaf
ireland	europe	pseudo leaf
immunoglobulin domains	protein domains	pseudo leaf
core binding factor alpha 1 subunit	core binding factors	pseudo leaf
tomography , optical	microscopy , electron	microscopy , electron , transmission
food safety	food contamination	pseudo leaf
antiretroviral therapy , highly active	biological therapy	pseudo leaf
united states government agencies	world health organization	pseudo leaf
epidural neoplasms	central nervous system neoplasms	pseudo leaf
aortic arch syndromes	aortic diseases	vascular ring
ribosome subunits , small , bacterial	ribosome subunits	pseudo leaf
heat exhaustion	heat stress disorders	heat stroke
public policy	policy	pseudo leaf
group structure	occupations	pseudo leaf
small business	marketing	pseudo leaf
nuclear reactors	biomedical and dental materials	pseudo leaf
cytoskeleton	extracellular vesicles	pseudo leaf
beer	beverages	pseudo leaf
carcinoma , transitional cell	abdominal neoplasms	pseudo leaf
protective clothing	transportation facilities	pseudo leaf
foundations	regional health planning	pseudo leaf
health planning support	financial management	financial management , hospital
arabia	middle east	pseudo leaf
dental plaque	dental equipment	pseudo leaf
child language	orientation	pseudo leaf
form perception	pattern recognition , physiological	pseudo leaf
cell respiration	cell physiological phenomena	pseudo leaf
metals , alkali	metals	metals , alkaline earth
body remains	organism attribute	pseudo leaf
capillary leak syndrome	shock	pseudo leaf
miller fisher syndrome	pseudo root	pseudo leaf
gaba agonists	molecular mechanisms of pharmacological action	chloride channel agonists
death domain superfamily	intracellular signaling peptides and proteins	pseudo leaf
collection	vocabulary , controlled	pseudo leaf
rehabilitation centers	ambulatory care facilities	pseudo leaf
psychology , applied	psychological phenomena	pseudo leaf
dental prosthesis design	dentistry	technology , dental
rna , fungal	rna	rna , viral
historical article	publishing	pseudo leaf
eating	nutritional physiological phenomena	pseudo leaf
dental clinics	dental facilities	pseudo leaf
pain , intractable	pain	pseudo leaf
skull	face	pseudo leaf
carrier state	disease transmission , infectious	pseudo leaf
hypertension , pulmonary	hypertension	pseudo leaf
adoption	human rights	pseudo leaf
surrogate mothers	persons	pseudo leaf
plasmids	amino acid sequence	pseudo leaf
chromosomes , human , y	x chromosome	chromosomes , human , x
medical savings accounts	insurance	pseudo leaf
rna , mitochondrial	rna	pseudo leaf
measles vaccine	viral hepatitis vaccines	pseudo leaf
surgical clearance	diagnostic services	pseudo leaf
truth disclosure	ethics	pseudo leaf
thymic factor , circulating	membrane glycoproteins	pseudo leaf
patient transfer	delivery of health care	pseudo leaf
egg proteins , dietary	dietary proteins	pseudo leaf
abdominal fat	subcutaneous fat	subcutaneous fat , abdominal
wnt proteins	intracellular signaling peptides and proteins	pseudo leaf
nucleotides , cyclic	nucleotides	cyclic amp
bodily secretions	carrier proteins	pseudo leaf
receptors , peptide	receptors , cell surface	pseudo leaf
phagocytosis	physiological phenomena	pseudo leaf
lakes	geological phenomena	pseudo leaf
legislation , hospital	legislation as topic	international health regulations
judgment	thinking	pseudo leaf
global health	population characteristics	pseudo leaf
intraocular lymphoma	thoracic neoplasms	pseudo leaf
hospital bed capacity , 100 to 299	hospital units	pseudo leaf
blood sedimentation	clinical laboratory techniques	pseudo leaf
cerebral arterial diseases	intracranial arterial diseases	pseudo leaf
observational study	clinical study	pseudo leaf
occupational health nursing	patient care	pseudo leaf
lung diseases , parasitic	intestinal diseases	pseudo leaf
reverse transcriptase polymerase chain reaction	gene silencing	pseudo leaf
sensory thresholds	nervous system physiological phenomena	pseudo leaf
retirement	employment	pseudo leaf
anatomy , veterinary	developmental biology	pseudo leaf
adaptor protein complex 1	adaptor proteins , vesicular transport	adaptor protein complex 2
economics , pharmaceutical	economics , hospital	hospital charges
ventricular function , right	cardiovascular physiological phenomena	ventricular function
pregnancy complications , cardiovascular	pregnancy complications	pseudo leaf
tool use behavior	pseudo root	pseudo leaf
colony count , microbial	clinical laboratory techniques	pseudo leaf
sensation disorders	neurologic manifestations	pseudo leaf
accessory nerve injuries	cranial nerve injuries	pseudo leaf
advanced cardiac life support	therapeutics	pseudo leaf
delivery rooms	intensive care units , pediatric	pseudo leaf
embryo disposition	pregnancy , animal	pseudo leaf
treatment outcome	diagnostic techniques and procedures	pseudo leaf
fees , pharmaceutical	financial support	research support as topic
dietary fiber	fruit proteins	pseudo leaf
absorption , radiation	chemical phenomena	pseudo leaf
myocardium	fetus	pseudo leaf
work capacity evaluation	models , nursing	pseudo leaf
kidney tubules , collecting	kidney	pseudo leaf
complement factor d	complement system proteins	pseudo leaf
pregnancy , ovarian	menstrual cycle	pseudo leaf
bone neoplasms	skull neoplasms	pseudo leaf
library administration	library science	library surveys
solute carrier family 22 member 5	atp binding cassette transporter , subfamily a	pseudo leaf
creatine kinase , mitochondrial form	creatine kinase	pseudo leaf
cell membrane structures	blood coagulation factor inhibitors	pseudo leaf
organic anion transport protein 1	amino acid transport systems , neutral	pseudo leaf
aortic valve insufficiency	heart valve diseases	aortic valve stenosis
psychology , sports	behavioral sciences	pseudo leaf
glasgow coma scale	psychiatric status rating scales	pseudo leaf
air filters	smoking devices	pseudo leaf
pathology , oral	dentistry	pseudo leaf
brain tissue transplantation	tissue transplantation	pseudo leaf
combat disorders	stress disorders , traumatic	pseudo leaf
reproductive rights	social control , formal	pseudo leaf
carcinoma , papillary	carcinoma	pseudo leaf
dental pulp	tooth germ	pseudo leaf
central nervous system fungal infections	central nervous system infections	pseudo leaf
veins	blood vessels	pseudo leaf
taste perception	perception	pseudo leaf
receptor , angiotensin , type 1	receptors , lipoprotein	pseudo leaf
models , immunological	clinical chemistry tests	pseudo leaf
ethics committees	guidelines as topic	pseudo leaf
transportation	rehabilitation	pseudo leaf
students , nursing	students , health occupations	pseudo leaf
lipid accumulation product	pseudo root	pseudo leaf
light signal transduction	signal transduction	pseudo leaf
mitosis modulators	pseudo root	pseudo leaf
bones of upper extremity	arm bones	pseudo leaf
health records , personal	medical records	pseudo leaf
brain injuries	brain hemorrhage , traumatic	pseudo leaf
nuclear export signals	protein sorting signals	pseudo leaf
abdominal cavity	multiple birth offspring	pseudo leaf
organ dysfunction scores	diagnostic techniques and procedures	pseudo leaf
online social networking	publishing	pseudo leaf
copper	metals , heavy	pseudo leaf
reproductive isolation	breeding	pseudo leaf
fuzzy logic	decision making	pseudo leaf
job description	psychology , industrial	pseudo leaf
base pairing	transcription , genetic	pseudo leaf
rectal diseases	lung diseases	pseudo leaf
psychology	behavioral sciences	pseudo leaf
intercellular signaling peptides and proteins	blood coagulation factor inhibitors	pseudo leaf
electronic supplementary materials	publications	pseudo leaf
insurance , disability	insurance selection bias	pseudo leaf
rna splice sites	core binding factors	pseudo leaf
mars	planets	moon
kidneys , artificial	infusion pumps	pseudo leaf
dilatation , pathologic	pathologic processes	pseudo leaf
prion diseases	autoimmune diseases of the nervous system	pseudo leaf
hepatitis b core antigens	hepatitis b antigens	hepatitis b surface antigens
carcinoma , ductal	adenocarcinoma	pseudo leaf
workplace violence	intimate partner violence	spouse abuse
abdominal muscles	muscle , skeletal	pseudo leaf
skull base	jaw	pseudo leaf
liver regeneration	pathologic processes	necrosis
type b personality	personality development	pseudo leaf
arthroplasty , replacement , shoulder	prosthesis implantation	arthroplasty , replacement , ankle
forms and records control	organization and administration	pseudo leaf
abortion , legal	treatment failure	pseudo leaf
chief executive officers , hospital	nursing staff	pseudo leaf
account book	publications	pseudo leaf
cataract extraction	decompression , surgical	microvascular decompression surgery
essay	communication	pseudo leaf
food analysis	epidemiologic measurements	pseudo leaf
heart	liver	pseudo leaf
social marketing	organization and administration	pseudo leaf
data mining	decision support techniques	pseudo leaf
olfactory perception	perception	pseudo leaf
popular work	publication formats	pseudo leaf
fractional precipitation	pseudo root	pseudo leaf
mutation	genetic variation	pseudo leaf
paper	technology , industry , and agriculture	pseudo leaf
hypothalamus , middle	pseudo root	hypothalamus , anterior
neurological rehabilitation	rehabilitation	pseudo leaf
maximum allowable concentration	safety	pseudo leaf
postoperative nausea and vomiting	respiratory aspiration	pseudo leaf
meningitis , pneumococcal	pseudo root	pseudo leaf
combined modality therapy	therapeutics	pseudo leaf
cardiac surgical procedures	surgical procedures , operative	cardiovascular surgical procedures
dynamic light scattering	scattering , radiation	pseudo leaf
association learning	learning	pseudo leaf
fish proteins , dietary	dietary proteins	poultry proteins
geographic area	western world	pseudo leaf
leishmania major	pseudo root	pseudo leaf
paralysis	neurologic manifestations	pseudo leaf
united states office of national drug control policy	legislation as topic	pseudo leaf
ovarian follicle	ovary	follicular fluid
stem cells	cells	pseudo leaf
genetic fitness	evolution , molecular	pseudo leaf
apnea	signs and symptoms , respiratory	pseudo leaf
brain injuries , traumatic	brain hemorrhage , traumatic	pseudo leaf
prenatal care	perinatal care	pseudo leaf
membranes , artificial	artificial organs	pseudo leaf
taste disorders	headache disorders	pseudo leaf
interview , psychological	behavioral disciplines and activities	pseudo leaf
adaptation , psychological	orientation	pseudo leaf
melanoma	central nervous system neoplasms	colloid cysts
pathology , veterinary	health occupations	pseudo leaf
protective devices	equipment and supplies	pseudo leaf
receptors , artificial	platelet membrane glycoproteins	pseudo leaf
plant viral movement proteins	viral structural proteins	pseudo leaf
attitude to health	attitude	pseudo leaf
neurotoxicity syndromes	pseudo root	poisoning
lighting	equipment and supplies	pseudo leaf
social behavior	psychology , social	pseudo leaf
olfactory pathways	laryngeal nerves	pseudo leaf
hematologic tests	diagnostic techniques , endocrine	pseudo leaf
bone density conservation agents	pseudo root	pseudo leaf
thoracic wall	epithelium	pseudo leaf
serine proteinase inhibitors	enzyme inhibitors	proton pump inhibitors
vascular diseases	eye diseases	pseudo leaf
exercise therapy	physical therapy modalities	pseudo leaf
dendrites	intercellular junctions	pseudo leaf
reproductive health	health status	pseudo leaf
epileptic syndromes	epilepsy	sudden unexpected death in epilepsy
survival rate	epidemiologic factors	pseudo leaf
oral ulcer	mouth diseases	pseudo leaf
patient care team	comprehensive health care	pseudo leaf
hospitals , general	hospitals , special	pseudo leaf
receptors , angiotensin	receptors , prostaglandin	pseudo leaf
iran	middle east	pseudo leaf
photons	luminescence	pseudo leaf
creatine kinase , bb form	creatine kinase	pseudo leaf
outpatient clinics , hospital	emergency service , hospital	pseudo leaf
femoral artery	retinal vessels	pseudo leaf
anemia , refractory	anemia	pseudo leaf
retinal degeneration	retinal diseases	wet macular degeneration
erythrocyte aggregation	cell physiological phenomena	pseudo leaf
portion size	diet	pseudo leaf
auditory brain stem implantation	prosthesis implantation	cochlear implantation
management information systems	organization and administration	pseudo leaf
secretory vesicles	transport vesicles	pseudo leaf
purchasing , hospital	hospital administration	pseudo leaf
college admission test	medical records	pseudo leaf
patient care planning	comprehensive health care	pseudo leaf
disease models , animal	models , animal	pseudo leaf
heavy metal poisoning	poisoning	mercury poisoning
pancreatic fistula	digestive system fistula	pseudo leaf
religion and science	religion	pseudo leaf
ventral striatum	brain	pseudo leaf
blood circulation	cardiovascular physiological phenomena	pseudo leaf
cobalt isotopes	gold	pseudo leaf
nursing service , hospital	emergency service , hospital	pseudo leaf
insurance , psychiatric	insurance , health	insurance , vision
anger	emotions	pseudo leaf
age groups	adult	young adult
medicare part b	medical assistance	pseudo leaf
vaccines , contraceptive	viral vaccines	aids vaccines
hardness	mechanical phenomena	pseudo leaf
salivary ducts	olfactory mucosa	pseudo leaf
oxytocin	growth hormone	pseudo leaf
smoking cessation	behavior	pseudo leaf
pulmonary surfactants	hematologic agents	pseudo leaf
education , nursing , associate	education , continuing	pseudo leaf
raf kinases	casein kinases	pseudo leaf
motor vehicles	technology , industry , and agriculture	sports equipment
systems biology	natural science disciplines	pseudo leaf
transplant recipients	tissue donors	pseudo leaf
chlorophyll a	pseudo root	pseudo leaf
logistic models	regression analysis	spatial regression
electronic waste	medical waste	pseudo leaf
central nervous system bacterial infections	central nervous system infections	pseudo leaf
united states public health service	world health organization	pseudo leaf
activities of daily living	human activities	pseudo leaf
rats , inbred shr	rats , inbred strains	rats , inbred bb
endothelial progenitor cells	adult stem cells	pseudo leaf
erythrocyte count	leukocyte count	lymphocyte count
virus shedding	microbiological techniques	pseudo leaf
sex work	attitude	pseudo leaf
nursing services	school health services	pseudo leaf
tumor escape	cell physiological phenomena	pseudo leaf
behavioral symptoms	behavior	pseudo leaf
relative biological effectiveness	toxicity tests	pseudo leaf
polysaccharides , bacterial	antigens , fungal	fungal polysaccharides
argentina	south america	pseudo leaf
veterans health	population characteristics	pseudo leaf
rna , algal	rna	pseudo leaf
selenium	metals , heavy	pseudo leaf
public housing	transportation facilities	pseudo leaf
carcinoma , squamous cell	neoplasms , squamous cell	pseudo leaf
peer influence	psychology , social	pseudo leaf
hematopoietic stem cell mobilization	immune tolerance	pseudo leaf
disability evaluation	public relations	pseudo leaf
hereditary sensory and motor neuropathy	complex regional pain syndromes	pseudo leaf
nursing assessment	nursing research	pseudo leaf
mediterranean islands	publication components	pseudo leaf
dental caries activity tests	diagnosis , oral	pseudo leaf
forensic pathology	forensic sciences	pseudo leaf
contraception	reproductive techniques , assisted	donor conception
occipital lobe	parietal lobe	pseudo leaf
manufactured materials	technology , industry , and agriculture	weapons
tonic pupil	eye diseases	pseudo leaf
microscopy , scanning probe	diagnostic imaging	pseudo leaf
nuclease protection assays	microarray analysis	pseudo leaf
sleep hygiene	psychotherapy	pseudo leaf
identity crisis	behavior	pseudo leaf
exosomes	subcellular fractions	pseudo leaf
state medicine	health education	pseudo leaf
aneurysm	intracranial arterial diseases	pseudo leaf
gene dosage	genetic techniques	pseudo leaf
diet , healthy	diet	pseudo leaf
pleural cavity	thorax	pseudo leaf
reproductive physiological phenomena	pseudo root	reproductive and urinary physiological phenomena
actin cytoskeleton	synapses	pseudo leaf
osteoporosis	dental physiological phenomena	pseudo leaf
blindness	eye diseases	vision disorders
education , medical , continuing	education , continuing	pseudo leaf
salt stress	physiological phenomena	pseudo leaf
lymphocyte antigen 96	pseudo root	pseudo leaf
dental prosthesis repair	dentistry	dental restoration failure
nervous system autoimmune disease , experimental	models , animal	pseudo leaf
hospitals , pediatric	hospitals , special	pseudo leaf
bronchial neoplasms	bronchial diseases	pseudo leaf
viral envelope proteins	membrane fusion proteins	pseudo leaf
anal canal	stomach	pseudo leaf
pain management	milieu therapy	pseudo leaf
mycobacterium tuberculosis	streptococcus	pseudo leaf
animal proteins , dietary	dietary proteins	pseudo leaf
lewis acids	organic chemicals	pseudo leaf
leukocyte reduction procedures	genetic therapy	pseudo leaf
lactation	digestive system physiological phenomena	pseudo leaf
child welfare	social welfare	pseudo leaf
disease eradication	disease transmission , infectious	pseudo leaf
neoplastic process	genetic variation	pseudo leaf
manual lymphatic drainage	drainage	pseudo leaf
mirror neurons	motor neurons	pseudo leaf
headache disorders , primary	headache disorders	pseudo leaf
asian continental ancestry group	continental population groups	american native continental ancestry group
glycogen storage disease type iv	lysosomal storage diseases , nervous system	glycogen storage disease type ii
single photon emission computed tomography computed tomography	ultrasonography , doppler , duplex	pseudo leaf
nuclear envelope	nuclear matrix	pseudo leaf
international classification of functioning , disability and health	residence characteristics	pseudo leaf
acute disease	disease attributes	pseudo leaf
patient positioning	surgical procedures , operative	pseudo leaf
emergence delirium	pathologic processes	pseudo leaf
dental etching	tooth preparation	acid etching , dental
biological transport , active	metabolism	pseudo leaf
focal epithelial hyperplasia	pathologic processes	pseudo leaf
metals , light	metals	pseudo leaf
paternal age	body weight changes	pseudo leaf
respiratory aspiration of gastric contents	respiratory physiological phenomena	pseudo leaf
dual use research	research	pseudo leaf
diagnostic techniques , neurological	diagnostic techniques and procedures	pseudo leaf
axillary artery	arteries	pseudo leaf
nanostructures	nanotubes	pseudo leaf
fatty liver	liver diseases , alcoholic	pseudo leaf
synovial cyst	jaw diseases	pseudo leaf
dermatitis , occupational	dermatitis , contact	pseudo leaf
multiplex polymerase chain reaction	staining and labeling	pseudo leaf
multiple system atrophy	multiple sclerosis	pseudo leaf
health plan implementation	delivery of health care	pseudo leaf
growth differentiation factor 2	growth differentiation factors	pseudo leaf
epithelial cells	cells	myocytes , smooth muscle
dermatitis , allergic contact	dermatitis , contact	pseudo leaf
death effector domain	protein interaction domains and motifs	pseudo leaf
cord factors	pseudo root	pseudo leaf
hospital departments	hospital units	pseudo leaf
educational activity	conceptual entity	pseudo leaf
fish oils	plant oils	pseudo leaf
poultry	animals , domestic	chickens
hypertensive retinopathy	retinal diseases	pseudo leaf
hospital bed capacity	regional health planning	pseudo leaf
pregnancy , prolonged	pregnancy	pseudo leaf
colitis	inflammatory bowel diseases	colitis , ulcerative
parental notification	human rights	pseudo leaf
indole alkaloids	pseudo root	pseudo leaf
database	information systems	pseudo leaf
airway management	anesthesia	pseudo leaf
child guidance	philosophy	pseudo leaf
sodium bicarbonate	sodium compounds	pseudo leaf
electrophoresis , cellulose acetate	electrophoresis	electrophoresis , starch gel
anxiety , separation	emotions	pseudo leaf
healthy lifestyle	nutrition therapy	pseudo leaf
tissue extracts	biological products	pseudo leaf
subcutaneous absorption	biochemical phenomena	pseudo leaf
receptors , chemokine	receptors , cytokine	pseudo leaf
peptide termination factors	core binding factors	pseudo leaf
bayes theorem	operations research	monte carlo method
tinnitus	pathologic processes	pseudo leaf
fees , medical	fees and charges	rate setting and review
computer graphics	data display	pseudo leaf
abortion applicants	tissue donors	pseudo leaf
skin absorption	physiological phenomena	pseudo leaf
african union	organization	pseudo leaf
travel	language	pseudo leaf
fatty acid transport proteins	anion transport proteins	pseudo leaf
musculoskeletal physiological phenomena	models , animal	pseudo leaf
phantom limb	neurologic examination	pseudo leaf
tablets	respiratory system agents	pseudo leaf
peripheral nerves	peripheral nervous system	spinal nerves
lipid metabolism disorders	metabolic diseases	pseudo leaf
forensic toxicology	environment and public health	pseudo leaf
biological monitoring	clinical laboratory techniques	pseudo leaf
live birth	pregnancy complications	pseudo leaf
hemodialysis units , hospital	intensive care units , pediatric	pseudo leaf
cold injury	pain	pseudo leaf
genetic testing	liquid biopsy	pseudo leaf
elasticity imaging techniques	radiography	pseudo leaf
speech recognition software	data display	pseudo leaf
violence	behavior	aggressive driving
gc rich sequence	base sequence	pseudo leaf
spores , fungal	bacteria	pseudo leaf
iron carbonyl compounds	iron compounds	pseudo leaf
friends	persons	pseudo leaf
uterine rupture	uterine diseases	pseudo leaf
psychology , developmental	behavioral sciences	pseudo leaf
kidney cortex necrosis	liver cirrhosis	pseudo leaf
genes , synthetic	genes , microbial	pseudo leaf
sugar acids	carbohydrates	amino sugars
housing	residence characteristics	pseudo leaf
s phase	pseudo root	pseudo leaf
fatty acids	fatty acids , unsaturated	trans fatty acids
laboratory procedure	equipment design	pseudo leaf
ultrasonic waves	mechanical phenomena	pseudo leaf
in situ hybridization , fluorescence	microarray analysis	pseudo leaf
health planning guidelines	health planning	pseudo leaf
anomalous left coronary artery	heart valve diseases	pseudo leaf
legislation , food	food packaging	pseudo leaf
sleep stages	behavior	pseudo leaf
renal blood flow , effective	renal circulation	pseudo leaf
excitatory amino acid transporter 4	glutamate plasma membrane transport proteins	excitatory amino acid transporter 1
protein corona	biomarkers	pseudo leaf
fibrin clot lysis time	blood coagulation tests	pseudo leaf
greek world	western world	pseudo leaf
clay	soil	pseudo leaf
laboratory infection	infections	pseudo leaf
eye injuries	eye diseases	pseudo leaf
lithium	sodium	pseudo leaf
estrogen receptor alpha	receptors , estrogen	pseudo leaf
models , molecular	models , biological	pseudo leaf
periodic acid	pseudo root	alcohols
muscle strength	physical examination	pseudo leaf
fetal resorption	labor , obstetric	pseudo leaf
probability learning	models , statistical	pseudo leaf
drug industry	product packaging	drug packaging
health impact assessment	health services research	pseudo leaf
pain perception	auditory perception	pseudo leaf
editorial	guideline	pseudo leaf
cerebellar neoplasms	cranial nerve neoplasms	pseudo leaf
religion and medicine	religion	pseudo leaf
ion channel gating	metabolism	pseudo leaf
veterans disability claims	employment	pseudo leaf
trigger points	pseudo root	pseudo leaf
books	publications	reference books
radiation oncology	medicine	pseudo leaf
metabolic side effects of drugs and substances	pharmacological phenomena	pseudo leaf
milk , human	foods , specialized	pseudo leaf
preexisting condition coverage	insurance , health	patient protection and affordable care act
intracellular membranes	intracellular space	cytoplasmic structures
conservative treatment	nursing care	pseudo leaf
thermal diffusion	diffusion	pseudo leaf
tobacco smoking	smoking	cigarette smoking
hepatitis , animal	hepatitis , viral , animal	pseudo leaf
fresh water	waste water	sewage
anatomical abnormality	anatomical structure	pseudo leaf
optical phenomena	models , theoretical	pseudo leaf
early growth response protein 1	transcription factors	pseudo leaf
brain neoplasms	peripheral nervous system diseases	pseudo leaf
adenocarcinoma in situ	lung neoplasms	pseudo leaf
reference standards	reproducibility of results	pseudo leaf
diabetes mellitus , type 2	diabetes mellitus	pseudo leaf
obstetric labor , premature	labor , obstetric	pseudo leaf
cadmium compounds	aluminum compounds	pseudo leaf
feeder cells	immune system	pseudo leaf
narrative medicine	psychological phenomena	pseudo leaf
meat proteins	dietary proteins	pea proteins
idea or concept	language	pseudo leaf
nigeria	africa , western	pseudo leaf
protective factors	population characteristics	pseudo leaf
cell adhesion molecules , neuronal	cell adhesion molecules	pseudo leaf
transition elements	carbon	pseudo leaf
gallbladder	pseudo root	bacterial secretion systems
muscle weakness	neuromuscular manifestations	pseudo leaf
urbanization	population dynamics	pseudo leaf
shoulder joint	leg bones	pseudo leaf
sclerosis	pathologic processes	pseudo leaf
social values	attitude	pseudo leaf
corneal perforation	corneal diseases	pseudo leaf
noise , occupational	noise	noise , transportation
blood protein disorders	hematologic diseases	pseudo leaf
absorption	chemical phenomena	pseudo leaf
chlorine compounds	gases	pseudo leaf
blood pressure monitoring , ambulatory	diagnostic techniques , digestive system	pseudo leaf
pseudomonas vaccines	vaccines	pseudo leaf
biologic function	finding	pseudo leaf
device approval	financial management	pseudo leaf
drug administration schedule	drug misuse	pseudo leaf
pain threshold	sensation	pseudo leaf
nuclear proteins	blood coagulation factor inhibitors	pseudo leaf
atp binding cassette transporter , subfamily g , member 2	atp binding cassette transporter , subfamily b	pseudo leaf
pancreas , artificial	artificial organs	pseudo leaf
yeast , dried	vegetables	pseudo leaf
spiral ganglion	autonomic nervous system	sympathetic nervous system
single person	family	pseudo leaf
intelligence	thinking	pseudo leaf
egg shell	organism forms	pseudo leaf
proportional hazards models	statistics as topic	pseudo leaf
freedom	civil rights	pseudo leaf
posterior cerebral artery	cerebral arteries	pseudo leaf
molar , third	dentin	pseudo leaf
erythrocyte indices	diagnostic techniques , cardiovascular	pseudo leaf
prenatal injuries	pathologic processes	pseudo leaf
community participation	social environment	pseudo leaf
organ preservation solutions	contraceptive agents	pseudo leaf
computed tomography angiography	multimodal imaging	pseudo leaf
physician payment review commission	prospective payment system	medicare payment advisory commission
radiography , dental , digital	surgical fixation devices	pseudo leaf
cerebral angiography	ultrasonography	pseudo leaf
ureter	urinary tract	pseudo leaf
prostatic diseases	pseudo root	prostatic hyperplasia
confidence intervals	sensitivity and specificity	predictive value of tests
splenic infarction	embolism	pulmonary infarction
rupture , spontaneous	hemorrhage	pseudo leaf
pulmonary ventilation	respiratory function tests	pseudo leaf
infection control practitioners	physicians	pseudo leaf
milk banks	biological specimen banks	tissue banks
elimination disorders	endocrine system diseases	pseudo leaf
directed molecular evolution	genetic techniques	pseudo leaf
new south wales	california	pseudo leaf
thyroid nuclear factor 1	transcription factors	pseudo leaf
parasitic sensitivity tests	clinical laboratory techniques	pseudo leaf
systematic review	consensus development conference	pseudo leaf
united states department of agriculture	industry	pseudo leaf
neuromuscular blocking agents	molecular mechanisms of pharmacological action	pseudo leaf
lip diseases	mouth diseases	salivary gland fistula
orthopedic procedures	surgical procedures , operative	pseudo leaf
genes , bacterial	genes , microbial	pseudo leaf
chronic disease	infections	pseudo leaf
insurance coverage	insurance selection bias	pseudo leaf
saliva	occupational groups	pseudo leaf
brain edema	brain ischemia	pseudo leaf
gene pool	sex distribution	pseudo leaf
plant proteins , dietary	dietary proteins	pea proteins
sex characteristics	neoplasm metastasis	pseudo leaf
epidemiology	environment and public health	pseudo leaf
orthodontic wires	orthodontic appliances , fixed	pseudo leaf
coup transcription factors	transcription factors	pseudo leaf
prospective studies	epidemiologic study characteristics	pseudo leaf
neonatal brachial plexus palsy	brain injury , chronic	pseudo leaf
atp binding cassette transporter , subfamily b , member 2	atp binding cassette transporter , subfamily a	pseudo leaf
western australia	australia	pseudo leaf
lymphatic system	pseudo root	immune system
enhanced recovery after surgery	nursing care	pseudo leaf
articulation disorders	pseudo root	speech sound disorder
eye infections , parasitic	eye infections	pseudo leaf
alpha rhythm	brain waves	pseudo leaf
poverty areas	employment	pseudo leaf
education , veterinary	education , medical	pseudo leaf
hydrophobic and hydrophilic interactions	chemical phenomena	pseudo leaf
meningitis , viral	bacterial infections	pseudo leaf
sand	soil	pseudo leaf
acidosis , renal tubular	lung diseases	pseudo leaf
seasons	evolution , planetary	pseudo leaf
cerebrospinal fluid pressure	blood pressure	pseudo leaf
dental marginal adaptation	dental physiological phenomena	pseudo leaf
maze procedure	pseudo root	pseudo leaf
health facility administrators	nursing staff	pseudo leaf
fluorescent antibody technique , direct	fluorescent antibody technique	fluorescent antibody technique , indirect
lens , crystalline	lens capsule , crystalline	pseudo leaf
prefrontal cortex	cerebral cortex	parietal lobe
crack cocaine	pseudo root	pseudo leaf
physicians ' offices	hospitals , private	pseudo leaf
receptors , glucocorticoid	receptors , pituitary hormone	pseudo leaf
north sea	pseudo root	pseudo leaf
atmospheric pressure	radiation	pseudo leaf
forensic genetics	genetics , medical	pseudo leaf
soil microbiology	environmental microbiology	pseudo leaf
tibia	arm bones	pseudo leaf
outline	publication formats	pseudo leaf
pattern recognition , visual	perception	pseudo leaf
jordan	middle east	pseudo leaf
radiotherapy dosage	blood chemical analysis	lactose tolerance test
genes , rev	genes , viral	pseudo leaf
rrna operon	genetic loci	pseudo leaf
united states department of veterans affairs	physicians	pseudo leaf
membrane potential , mitochondrial	membrane potentials	pseudo leaf
pair bond	sex distribution	pseudo leaf
leukocytes	leukocytes , mononuclear	pseudo leaf
dental casting technique	technology , dental	pseudo leaf
ear neoplasms	mandibular diseases	pseudo leaf
random allocation	evaluation studies as topic	pseudo leaf
artificial lens implant migration	prosthesis implantation	pseudo leaf
radiation hybrid mapping	restriction mapping	pseudo leaf
sepsis	bacterial infections	pseudo leaf
pediatrics	emergency medicine	pseudo leaf
microtubule proteins	blood coagulation factor inhibitors	pseudo leaf
asthma , occupational	nausea	pseudo leaf
lateral thalamic nuclei	thalamic nuclei	anterior thalamic nuclei
acoustic impedance tests	pseudo root	bone conduction
nadh dehydrogenase	aldehyde dehydrogenase 1	pseudo leaf
radiation effects	pseudo root	oxidative stress
pregnancy proteins	seminal plasma proteins	pseudo leaf
logical observation identifiers names and codes	equipment and supplies	pseudo leaf
dna replication timing	genetic phenomena	pseudo leaf
saccharomyces cerevisiae proteins	toxins , biological	pseudo leaf
psychological tests	pseudo root	personality tests
bacillus subtilis	helicobacter	pseudo leaf
occupational health	population characteristics	pseudo leaf
mathematical computing	algorithms	pseudo leaf
limited english proficiency	communication	pseudo leaf
elbow joint	foot joints	pseudo leaf
antisense elements ( genetics )	biomarkers	pseudo leaf
water pollution , chemical	environmental pollution	water pollution
antibodies , immobilized	antibodies	pseudo leaf
tissue engineering	bacterial typing techniques	pseudo leaf
patient discharge	diagnostic services	pseudo leaf
connective tissue cells	muscle cells	pseudo leaf
genome , plant	genome	pseudo leaf
focal infection	bacterial infections	pseudo leaf
amino acid transport systems , basic	amino acid transport systems	amino acid transport systems , neutral
drugs , chinese herbal	pharmaceutical preparations	plant extracts
wounds , penetrating	pseudo root	nasal septal perforation
expert systems	computing methodologies	pseudo leaf
insect viruses	rna viruses	pseudo leaf
quality assurance , health care	quality of health care	pseudo leaf
lysine	amino acids , aromatic	pseudo leaf
midline thalamic nuclei	thalamic nuclei	pseudo leaf
ultrasonic surgical procedures	ablation techniques	pseudo leaf
infection control , dental	oral hygiene	pseudo leaf
hot melt extrusion technology	technology , pharmaceutical	pseudo leaf
tuberculosis , pulmonary	respiratory tract infections	pseudo leaf
rna precursors	rna caps	pseudo leaf
philosophy , medical	philosophy	philosophy , dental
problem solving	learning	pseudo leaf
orthopedic surgeons	physicians	pseudo leaf
streptavidin	pseudo root	pseudo leaf
intention to treat analysis	epidemiologic study characteristics	pseudo leaf
insulin antibodies	antibodies , neutralizing	pseudo leaf
type d personality	personality development	pseudo leaf
auditory threshold	auditory perception	pseudo leaf
neoplasm recurrence , local	pathological conditions , anatomical	pseudo leaf
cyclic imp	pseudo root	pseudo leaf
personnel management	organization and administration	pseudo leaf
state health planning and development agencies	world health organization	pseudo leaf
catalog	catalog , commercial	pseudo leaf
fluorescence	models , theoretical	pseudo leaf
handbook	publication components	pseudo leaf
counseling	remote consultation	distance counseling
recycling	technology	pseudo leaf
family separation	family	pseudo leaf
cholinergic antagonists	cholinergic agents	cholinergic agonists
rats , inbred wf	rats , inbred strains	rats , inbred dahl
dental records	records	pseudo leaf
integrated advanced information management systems	health information management	pseudo leaf
pneumonia , pneumococcal	pseudo root	pseudo leaf
fluorescent dyes	laboratory chemicals	pseudo leaf
eye infections , viral	eye infections , bacterial	pseudo leaf
muscle fibers , skeletal	tooth germ	pseudo leaf
plaque , amyloid	physiological phenomena	pseudo leaf
serotonin antagonists	cholinergic agents	pseudo leaf
temporal bone	arm bones	pseudo leaf
biologically active substance	chemical viewed structurally	pseudo leaf
dictionary , dental	dictionary	pseudo leaf
protein degradation end products	blood coagulation factor inhibitors	pseudo leaf
vomiting	signs and symptoms , digestive	pseudo leaf
lecture	publication formats	pseudo leaf
reality testing	personality tests	pseudo leaf
nerve regeneration	regeneration	pseudo leaf
sequence deletion	mutagenesis	pseudo leaf
rural health	population health	pseudo leaf
vaginal fistula	respiratory tract fistula	pseudo leaf
spindle apparatus	cytoskeletal proteins	pseudo leaf
burn units	hospital units	pseudo leaf
skin ulcer	skin diseases	pseudo leaf
isotopes	chemical viewed structurally	pseudo leaf
ferm domains	protein domains	pseudo leaf
fat body	animal population groups	pseudo leaf
ion channels	membrane glycoproteins	pseudo leaf
glia maturation factor	transcription factors	pseudo leaf
sugar alcohols	ethanol	pseudo leaf
bile ducts	vesicular transport proteins	pseudo leaf
health facility environment	residence characteristics	pseudo leaf
tears	esophagus	pseudo leaf
animals , inbred strains	animal population groups	animals , laboratory
intensive care units	intensive care units , pediatric	pseudo leaf
cortical spreading depression	sensation	pseudo leaf
hair cells , auditory , outer	hair cells , auditory	pseudo leaf
umbilical cord	embryonic structures	pseudo leaf
chemical engineering	technology	pseudo leaf
williams syndrome	abnormalities , multiple	pseudo leaf
organizations	consumer organizations	pseudo leaf
rectal fistula	respiratory tract fistula	pseudo leaf
atp binding cassette transporter , subfamily b , member 3	atp binding cassette transporter , subfamily b	pseudo leaf
house calls	hospitalization	pseudo leaf
historical geographic locations	western world	roman world
cpg islands	intracellular signaling peptides and proteins	pseudo leaf
angiotensin ii type 1 receptor blockers	angiotensin receptor antagonists	angiotensin ii type 2 receptor blockers
adrenal glands	endocrine system	adrenal medulla
science in the arts	art	pseudo leaf
patient identification systems	office management	pseudo leaf
mental healing	spiritual therapies	pseudo leaf
online systems	information storage and retrieval	pseudo leaf
brain diseases	nervous system diseases	pseudo leaf
observer variation	body weights and measures	pseudo leaf
hypertension , portal	hypertension	pseudo leaf
postoperative complications	hemorrhage	pseudo leaf
animal fur	hair	pseudo leaf
silicon dioxide	inorganic chemicals	pseudo leaf
sudden infant death	hypoxia	fetal hypoxia
continuity of patient care	comprehensive health care	pseudo leaf
hiv long terminal repeat	genes	pseudo leaf
tai ji	psychotherapy	pseudo leaf
antigens , differentiation	antigens , neoplasm	pseudo leaf
neck injuries	wounds and injuries	pseudo leaf
safety management	safety	pseudo leaf
data systems	information systems	pseudo leaf
serum sickness	pseudo root	pseudo leaf
sentinel surveillance	population surveillance	pseudo leaf
dental instruments	dental equipment	pseudo leaf
schools , pharmacy	schools , health occupations	pseudo leaf
purple membrane	nuclear matrix	pseudo leaf
food , preserved	foods , specialized	pseudo leaf
nitrogen compounds	free radicals	pseudo leaf
community psychiatry	psychiatry	pseudo leaf
names	conceptual entity	pseudo leaf
abdomen , acute	respiratory tract infections	pseudo leaf
hydrogen bonding	chemical phenomena	pseudo leaf
facial asymmetry	congenital abnormalities	pseudo leaf
quartz	metals , heavy	pseudo leaf
sodium acetate	acetic acid	pseudo leaf
receptors , tumor necrosis factor	receptors , cytokine	pseudo leaf
receptors , thyroid hormone	receptors , parathyroid hormone	pseudo leaf
cell fusion	gene transfer techniques	pseudo leaf
group practice , dental	professional practice	pseudo leaf
portugal	publication components	pseudo leaf
infarction , posterior cerebral artery	cerebral infarction	infarction , middle cerebral artery
adrenal cortex function tests	diagnostic techniques , endocrine	pseudo leaf
posture	locomotion	pseudo leaf
transition to adult care	hospitalization	pseudo leaf
air bags	dental equipment	pseudo leaf
silver staining	neutron capture therapy	pseudo leaf
aids dementia complex	muscular diseases	pseudo leaf
pulmonary valve	heart valves	pseudo leaf
cos cells	cell line	pseudo leaf
renal insufficiency	lung diseases	pseudo leaf
ethics , professional	philosophy , dental	ethics , dental
abbreviations	publication formats	pseudo leaf
